NO ./path
EA ./path
SO ./path
WE ./path

F 163,120,70
C 162,209,242

1111111111
1000000001
10001000001
1000010001
1000010001
100N000101
1000000001
1000010001
1000000101
1111111111
